NO   textures/ovi1.png
SO textures/ovi2.png
WE textures/ovi3.png
EA textures/ovi4.png
F 00,00,00
C 00,00,00

11111111111111111
10000000100011101
1100000010000000D
111000001N0000001
11111111111111111
