NO   textures/ovi1.png
SO textures/ovi2.png
WE textures/ovi3.png
EA textures/ovi4.png
F 40,160,00
C 80,50,00

1111111111111
D000000000001
100000000W001
1111111111111