NO ./textures/ovi4.png
SO ./textures/ovi3.png
WE ./textures/ovi2.png
EA ./textures/ovi1.png

F 204,204,204
C 153,204,255

1111111111111111111111111111111111111111
10000000000000000000000000000000000000001
1000000000000000000000000000000000000001
1000000000000000000000000000000000000001
1000111100000000000011100000000000000001
1000000000000000000011100000000000000001
1000000000000000000000000000000000000001
1000000000000010101000000000000001111111
1000011000000001010100000000000001111111
100001110000000000000000000000000000001
1000011000000000000000000000000000000001
1111111111111100000000000000000000000001
1111111111111100N00000000000000000000001
1000000001100000000000000111100000000001
1000000001100000000000000111100000000001
1000000001100000000000000111100000000001
1000000000000000000000000000000000000001
1000000000000000000000000000000000000001
1111111111111111111111111111111111111111