
NO   textures/alice.png
SO textures/yunchia.png
WE textures/lempi.png
EA textures/miyuki.png
F 2,20,20
C 200,200,180

1111111111
1000000001
1000N00001
1111111111
