
NO   textures/alice.png
SO textures/yunchia.png
WE textures/lempi.png
EA textures/miyuki.png
F 2,20,20
C 200,200,180

11111111111111111111111111111
10000000000000000000000000001
10000000011110000011110000001
10000000100001000100001000001
10000001000000111000000100001
10000010000000010000000010001
10000001000000000000000100001
10000000100000000000001000001
1                           1
10000000010000000000010000001
10000000001000000000100000001
10010001001000000100000000001
10000000000001000010000000001
10000N00000000100100000000001
10000000000000000000000000001
100000000000000000000000000011111
11111111111111111111111111111
