NO ./textures/alice.png
WE ./textures/lempi.png
SO ./textures/yunchia.png
EA ./textures/miyuki.png
F 9,78,255
C 0,225,255
 11111111111
100001001101
100000000101
110000N00001
100000000001
111111111111