NO ./textures/alice.png
WE ./textures/lempi.png
SO ./textures/yunchia.png
EA ./textures/miyuki.png
F 9,78,255
C 0,225,255
1111111
10E01011
101001
1100N11
1    1
1111111