
NO   textures/alice.png
SO textures/yunchia.png
WE textures/lempi.png
EA textures/miyuki.png
F 2,20,20
C 200,200,180

11111111
1000000011
1000N00001
1111111111
