NO   textures/shroom.png
SO textures/koivu2.png
WE textures/manty.png
EA textures/koivu.png
F 2,20,20
C 200,200,180

111111111111111111
100001111000000001
100000000001100001
11100000W000000001
100000011000011111
100011000000000001
100000111000111001
111111111111111111