NO   textures/alice.png
SO textures/yunchia.png
WE textures/lempi.png
EA textures/miyuki.png
F 2,20,20
C 200,200,180

111111111111111111
100000000000000001
100000000000000001
11100000W000000001
100000000000000001
100000000000000001
111111111111111111