NO   textures/sei.png
SO textures/sei.png
WE textures/sei.png
EA textures/sei.png
F 2,20,20
C 200,200,180

111111111111111111
100000000000011101
100000000010000001
11100N000000100001
111111111111111111