NO ./textures/ovi4.png
SO ./textures/ovi3.png
WE ./textures/ovi2.png
EA ./textures/ovi1.png

F 204,204,204
C 153,204,255

1111111111111111111111111111111111111111
1000000000000000000000000000000000000101
1111111111111100000000000000000000000001
1111111111111100S00000000000000000000001
1000000001100000000000000111100000000001
1000000001100000000000000111100000000001
1000000001100000000000000111100000000001
1000000000000011111110000000000000000001
10000000000000111111110000000000000000001
11111111111111111111111111111111111111111