NO   textures/ovi1.png
SO textures/ovi2.png
WE textures/ovi3.png
EA textures/ovi4.png

F 255,203,164
C 139,0,0

1111111111111111111111111
1000000000000000000000001
1001001000010010000000001
100100100001010000000001
100100100001100000000001
100100100001010000000011
100100100001001000000011
100100111101000100000001
1000000000000N0000011111
111111111111111111111111