
NO   ./textures/ovi1.png
SO ./textures/ovi2.png
WE ./textures/ovi3.png
EA ./textures/ovi4.png
F 2,20,20
C 200,200,180

11111D1111
1100000011
1000N00001
1111111111
