NO   textures/ovi1.png
SO textures/ovi2.png
WE textures/ovi3.png
EA textures/ovi4.png

F 200,200,180
C 2,20,20

111111111111111111111111
100001111000000000000011
100000000001110000000001
111000000000010000000001
100000011111111111000001
100010000000000001000001
100000011000111001000111
100001111000000000000001
100001000001100000001001
11111100W000000000001111
100000011000011111000001
100011000000000001000001
100000111001111001000001
100000111111000001000001
100000000011100000011001
111000000000000000000001
100000011000011111000001
100011000000000001000001
100000111000111001000001
111111111111111111111111