NO   textures/ovi1.png
SO textures/ovi2.png
WE textures/ovi3.png
EA textures/ovi4.png
F 00,00,00
C 00,00,00

11111111111111111
100000011000011101
100000000010000001
11100N000000100001
11111111D111111111