NO ./tiles/wall/wall_n.png
SO ./tiles/wall/wall_s.png
WE ./tiles/wall/wall_w.png
EA ./tiles/wall/wall_e.png

F 220,100,0
C 225,226,0

111111111111
100000000001
10000N000001
1000000Y0001
111111111111
